R        920    780       
NO ./src/Meme1.xpm
SO ./src/Meme2.xpm
WE ./src/Meme3.xpm
EA ./src/Meme4.xpm
S ./src/Meme5.xpm
F 220,100,0
C 220,30,0
111111111111111111111111111111111111111111
100000000000000000000000002000000000000001
100000000000000000000000000000000000000001
100000000111111100000000000000000000000001
100000000000000100000000000000000000000001
100000000100000100000000000000000000000001
100000000111111100000000000000000000000001
100000000000000000000000000000000000000001
100000000000000000000000000000000000000001
100000000000000000000200000000000000000021
120000000000000W00000000000000000000000001
100000000000000000000000000000000000000001
122222222222222222200000000000000000000001
100000000000000000002000000000000000000001
111111111111111111111111111111111111111111