R        920    780       
NO ./src/Meme1.xpm
SO ./src/Meme2.xpm
WE ./src/Meme3.xpm
EA ./src/Meme4.xpm
S ./src/Meme5.xpm
F 220,100,0
C 220,30,0
11111
10001
10N01
10001
11111
