R   1920 1780       
NO ./src/Meme9.xpm
SO ./src/Meme2.xpm
EA ./src/Meme4.xpm
WE ./src/Meme3.xpm
S ./src/sprite.xpm
F 120,100,20
C   220, 150,100
11111111111111111111111111111
10000000001111100000000000001
10110000011110100020000010001
1011000000000000000000010001
10110000011100000000000010001
10000000001100000111011110001
11110111111111011100000010001
11110111111111011101010010001
1100000011010101110000010001
10002000000002001100020010001
10000000000000011010100100011
1100N0111110101011111011110001
11110111111101011111011110001
11111111111111111111111111111